111111111111111111
1CG1P0110C100010C1
100000E10110001001
100100110000101001
100100000011100001
100001011000001001
1011010C1011111011
1C00011010G01C0001
10010100G01G000101
10010100G01G000101
110101111011011101
1C0100C00000C00001
111111111111111111
